###############################################################
# #       #       #         # #             #           #     #
# ### # # ### ### # # ##### # # ##### ##### ### # ##### # ### #
#   # # #     #   # #     # #     #   #   #   # # #   #   # # #
### # # ####### ### ##### # ####### ### # ### # # # # ##### # #
#   # #   #       # #     #   #     #   #   # # #   # #   #   #
# ### ### ####### ### ####### # ######### ### # ##### # ### ###
#   #   #     # # #   # #   # # #         #   # #   # #   #   #
### ### ##### # # # ### # # # # # ####### # ##### # # # # ### #
#   #     #   # #   #   # #   # # #       # #     #   # #   # #
# ##### ### ### ##### # # ##### # # ####### ### ####### # # # #
# #   # #   #     #   # #   #   # # #     #   #   #   # # # # #
# # # ### ##### # ### # ### # ### ### ### ### # # # ### # ### #
#   #     #     #     #   #   #         #   # # # # #   #     #
############# ######### ####### ######### # # ### # # #########
# #   #       #   #   # #     #   # #     # #     # #   #     #
# # # # ### # # # ### # # ### ### # # ############# ### ##### #
# # # # # # # # #   #   # # #   # # #     #       #   #   #   #
# # # # # # ### ### ##### # ### # # ##### # # ##### # ### # # #
#   #     #       #           #         #   #       #       #  
###############################################################
